// Map save file (Packed with algorithm X when implemented)
   ###############          #######
   #.............#          #.....#
   #.............############.....#
   #....@.........................#
   #.............############.....#
   ######.#####.##          #.....#
        #.#   #.#####       #######
        #.#   #.....#
#########.#   #####.######
#.........#       #......#
#.........######  ########
#..............#
##############.######
             #......#
             ########